Re, Re, Hhd, Re, Hhd, Gd, Re^Es, Rb, Gd, Gd, Gd, Gd^Fdw, Gd^Fmw, Gd, Gd, Gd, Gd, Gd, Gd, Gd, Gd, Gd, Gs, Gs^Fmw, Gs^Fmw, Gs^Fmw, Gg^Fp, Gg^Fp, Gg, Gg^Fp, Gg^Fms, Gg^Fp, Gg^Fms
Rb, Rb^Edb, Re, Hhd^Es, Re, Gd, Rb^Vct, Rb, Gd, Gd, Gd, Gd^Fdw, Gd, Gd, Gs^Fmw, Gd^Fdw, Gd^Fdw, Gd^Fdw, Gs^Fmw, Gd, Gs, Gs^Es, Gs^Fmw, Gs^Fmw, Gs^Fp, Gs^Fmw, Gg^Fp, Gg^Efm, Gs^Fp, Gg^Fms, Gs^Fms, Gg^Fms, Gs^Fp
Hhd, Rd^Edb, Rd^Edb, Re, Rb^Es, Re, Re, Rb^Edb, Rb^Edb, Re^Edb, Re^Vct, Re^Edb, Gd, Hhd^Fdw, Hhd^Fdw, Hh^Fmw, Gd^Em, Gd, Gd, Gs, Gd, Gs, Gs^Fmw, Gs^Fmw, Gs^Fp, Gg, Ww, Gg^Fp, Wwf, Gs^Fp, Gs^Fp, Gs^Fms, Gg^Fp
Hhd^Edb, Rd^Edb, Re^Dr, Rb, Gd, Hhd, Gd, Rb, Rb^Edb, 2 Ke, Ce, Hhd^Fdw, Gd, Gd, Gd, Hh^Fdw, Hh^Fp, Gd^Em, Gs^Fp, Gs^Fmw, Gs^Fp, Gs^Fp, Gs^Fmw, Gs^Fmw, Gs, Wwf^Ewf, Gg^Fet, Ww, Wwf^Ewl, Gg^Fms, Gs^Fms, Gg^Em, Gg^Fds
Rb, Rd^Edb, Rb^Edb, Gd, Gd, Gd^Edb, Re, Re, Re^Es, Ce, Rb, Ce, Gd, Gd^Fdw, Gd^Fmw, Hh^Fdw, Hh^Fmw, Gg^Fmw, Gs^Fmw, Gs, Gs^Fp, Gs^Fmw, Gs^Fmw, Gg^Fp, Gs, Gg^Efm, Gg, Ww^Ewl, Gg^Efm, Gs^Fms, Gs^Fms, Gs^Fds, Gg^Fds
Rb, Rb, Rb, Rb, Hhd^Fmw, Gd, Re, Rd^Ecf, Re, Rb^Edb, Re, Gd, Gd, Gd, Gd^Fmw, Gd^Fdw, Gs^Fmw, Gs^Fmw, Gs^Fmw, Gs^Fp, Gs^Fmw, Gs^Fp, Gs^Fmw, Gs^Fp, Gs^Fms, Gs^Fms, Gs^Fms, Gg^Fp, Gg^Efm, Gg, Gg^Fms, Gs^Fds, Gg^Fms
Rb, Gd^Es, Gd, Hhd^Fdw, Gd, Re^Vct, Rd, Rd^Edb, Re, Gd, Gd, Gd, Gd, Gd^Fdw, Gd^Fdw, Gs^Fmw, Gs, Gs^Em, Gs^Fmw, Gs^Fmw, Gs, Gs^Fmw, Gs^Fmw, Gs^Fp, Gg^Fms, Gs^Fms, Gg^Em, Gg^Fp, Gg^Fms, Gg^Fp, Gg^Fp, Gg^Fms, Gg^Fms
Re, Re, Gd^Fmw, Gd^Fdw, Hhd^Fmw, Re, Gd, Re, Re^Vct, Hhd^Fmw, Gd^Fdw, Gd, Gd, Gd^Em, Gd^Fdw, Gd^Fdw, Gs^Fdw, Gs, Gs^Fp, Gs^Fdw, Gs^Fdw, Gg^Fp, Gs^Fmw, Gs, Gg^Fms, Gg^Efm, Gg^Fp, Gg^Fms, Gg^Fds, Gg^Fds, Hh^Fms, Hh^Fms, Gg^Fms
Gd^Fdw, Gd, Gd^Fmw, Gs^Fmw, Gd^Fmw, Gs, Hh^Fdw, Gd, Hhd^Fdw, Hhd^Fmw, Hh^Fmw, Gd^Fp, Gs^Em, Gd^Fdw, Gs^Fmw, Gs^Fmw, Gs^Fmw, Gs^Fmw, Gs^Fmw, Gg^Fp, Gg^Ve, Gg^Fp, Gg^Fp, Gg^Fp, Gg^Fms, Gg^Fp, Gg^Fms, Gg^Fms, Gs^Vl, Gg^Fds, Gg^Fms, Gg^Fms, Gg^Fp
Gd^Fdw, Gd, Gd, Gs, Gs, Gs^Fmw, Gs^Fmw, Hh^Fmw, Gd^Em, Hh^Fmw, Gd^Fmw, Gd^Fmw, Gd^Fmw, Gs^Fp, Gs^Fmw, Gs^Fp, Gs^Fp, Gs^Fmw, Gs^Fp, Gs^Fmw, Gs^Em, Gs^Em, Gs, Gg^Fp, Gg^Fp, Gg^Fms, Gs, Gs, Gg^Fp, Gg^Fp, Gg^Fms, Gg^Fp, Gg^Fp
Gd, Gd, Gs, Gs, Gs^Fdw, Gd^Fmw, Gd^Fdw, Gd^Fp, Gd^Fmw, Gd^Fmw, Gd^Fdw, Gd^Fp, Gd^Fp, Gs^Fmw, Gd^Fmw, Gs^Fmw, Gs, Gs^Fp, Gs^Fmw, Gs^Fmw, Gg^Fp, Gg^Fms, Gg^Fms, Gg^Fms, Gg^Fp, Gg^Fp, Gs^Fms, Gg^Fp, Gg^Fp, Gg^Fms, Hh^Fms, Hh^Fms, Hh^Fp
Gd, Gs, Gd^Es, Gd, Gd^Fdw, Gd^Fmw, Gd, Gd^Fdw, Gd, Gd^Fdw, Gd^Fdw, Gd^Fp, Gs^Fdw, Gs^Fp, Gs^Fmw, Gs^Fp, Gs^Em, Gs^Emf, Gg^Fp, Gg^Fp, Gg^Fmw, Gg^Fp, Hh^Fms, Hh^Fms, Gs^Fp, Gs^Fms, Gs, Gs, Gs^Fms, Gg^Fp, Gg^Fms, Hh^Fms, Gg^Fms
Gd^Fdw, Gd, Gd, Gd^Es, Re^Edb, Re, 3 Ke, Gd, Gd^Fdw, Gd^Fdw, Gs^Fmw, Gs^Fdw, Gs^Fmw, Gs^Fp, Gs^Fmw, Gs^Fmw, Gs^Fmw, Gs^Fp, Gg^Fmw, Gg^Fp, Gg^Fp, Hh^Fp, Gg^Fp, Hh^Fp, Gs^Fp, Gs^Fp, Gs^Fp, Gs, Gs, Gg^Fp, Gg^Fms, Hh^Fms, Hh^Fp
Re, Gd, Re^Vct, Gd, Rd^Edb, Rd^Ecf, Ce, Ce, Gd, Gd^Fdw, Gd, Gs^Fdw, Gs^Fp, Gs^Fdw, Gs^Fmw, Gs^Fp, Gs^Fmw, Gs^Fp, Gs^Fp, Gg^Fms, Gg^Efm, Gg^Fms, Gs^Fms, Gs^Fp, Gs, Gs^Fp, 1 Ke, Gs^Fp, Gs^Es, Gs, Gg^Fms, Gg^Fms, Hh^Fds
Re, Re, Re, Rb, Rd^Es, Rd, Rb^Edb, Ce, Re^Es, Gs^Fmw, Gd^Fdw, Gd, Gs^Fmw, Gs^Fdw, Gd^Fmw, Gs^Fp, Gs^Fmw, Gs^Fp, Gg^Fms, Gg^Fms, Gg^Fp, Gg^Em, Gs^Fds, Gs^Fp, Gs^Fms, Gs^Fp, Ce, Ce, Gs, Gg^Fms, Gg^Fds, Gg^Fds, Gg^Fp
Gd, Re^Es, Gd, Re^Es, Re, Rb^Edb, Re^Vct, Rb, Gd, Gs^Fdw, Gs^Fdw, Gs^Fmw, Gs^Fmw, Gd^Fdw, Gs^Fmw, Gs^Fp, Gs^Fp, Gg^Fp, Gg^Fms, Gg^Fms, Gg^Fms, Gs^Fds, Gs^Fds, Gs^Fms, Gs^Vct, Ce, Ke, Ce, Gs^Em, Gg^Fms, Gg^Fms, Gg^Fms, Gg^Fds
Rb, Gd^Edb, Re^Edb, Re^Edb, Re, Gd, Gd, Re, Gs^Fdw, Gd, Gs, Gs^Fmw, Gs^Fmw, Gs^Fp, Gs, Gg^Fp, Hh^Fp, Gg^Fp, Gg^Fp, Gg^Fp, Gg^Fp, Gs^Fds, Gg^Fms, Gg^Fms, Gg^Fms, Gs, Gg^Fp, Gs, Gs^Fp, Gs^Fms, Gs^Fms, Gs^Fp, Gs^Fms
Rb, Rb^Dr, Re^Edb, Gd, Gd, Re, Gd^Fdw, Gd, Gd^Fmw, Gs^Fmw, Gs^Fmw, Gs^Fmw, Gs^Fmw, Gs^Fp, Gs^Fmw, Gs^Fmw, Hh^Fmw, Gs^Fp, Gs, Gs^Em, Gs^Fp, Gg^Fms, Gg^Fp, Gg^Fms, Gs^Em, Gs, Gg^Fp, Gg^Fms, Gs^Fp, Gs^Fms, Gs, Gs^Em, Gg^Fp
Gd, Re^Edb, Gd^Edb, Gd, Gd^Fdw, Gd^Fmw, Gd^Fmw, Gd^Fmw, Gd^Fp, Gs^Fmw, Gs^Fp, Gd^Fp, Gs^Fmw, Hh^Fmw, Gg^Fp, Gg^Fmw, Gg^Fp, Gg^Fp, Gs^Fp, Gs^Fp, Gs^Fp, Gg^Fms, Gg^Efm, Gs, Gg^Es, Gs, Gs^Fmw, Gs^Fp, Gs^Fp, Gs^Fp, Gs^Fmw, Gg^Fp, Gg^Fp
Gd, Re, Gs, Gd, Gs^Fp, Gd^Fdw, Gs^Fmw, Gd^Fp, Gs^Fp, Gd, Gs^Em, Gd^Fmw, Gs^Fmw, Gs^Fmw, Gs, Gg^Fp, Gs, Gg^Fms, Gg^Fms, Gg^Fms, Gg^Fms, Gs^Ve, Gg^Fms, Gg^Fp, Gs^Fmw, Gll, Gll^Em, Gll^Fmw, Gs^Em, Gs^Em, Gs^Em, Gg^Fp, Gg^Fp
Gd^Fdw, Gs^Es, Gd^Fdw, Gd^Em, Gs^Fp, Gd^Fmw, Gd^Fmw, Gd^Fmw, Gd^Fmw, Gd^Em, Gd^Fmw, Gg^Fp, Gs^Fp, Gs^Fmw, Ce, Ce, Gs, Gs, Gg^Fms, Gg^Fds, Gg^Fms, Gg^Fms, Gs^Fms, Gs^Fms, Gs^Fp, Gs^Em, Gll^Emf, Gll^Em, Gll^Emf, Gll^Emf, Gs^Em, Gg^Fmw, Gs^Fmw
Gd^Fdw, Gs^Fdw, Gs^Em, Gs, Gs^Fp, Gs, Gs^Fp, Gd^Fp, Gd^Emf, Gd^Fmw, Gg^Fmw, Hh^Fp, Hh^Fp, Gs, Gs^Fmw, Gs^Vct, Gg^Fp, Gs^Efm, Gg^Fms, Gg^Fds, Hh^Fms, Gg^Fp, Gs^Fp, Gs^Fp, Gs^Fmw, Gs^Em, Gll^Fdw, Gll^Em, Gg^Fmw, Gll^Em, Gg^Fmw, Gs^Fmw, Gg^Fp
Gd, Gd^Fmw, Gd^Fp, Gd^Fp, Gd^Fp, Gs^Fp, Gd^Fp, Gd^Em, Gd^Fp, Gg^Fmw, Gg^Fp, Hh^Fp, Gg^Fp, Hh^Fp, Gs, Gs, Gs, Gg^Fp, Gg^Fp, Gg^Fp, Hh^Fp, Hh^Fp, Gg^Fp, Gs^Fp, Gg^Fp, Gll^Fmw, Gg^Fp, Gg^Fmw, Gg^Fp, Gg^Fmw, Gg^Fp, Gg^Fp, Gg^Fp
