Gll^Qhh, Gll^Qhhf, Gll^Qhhf, Rb, Rb^Qhh, Ss, Rb^Qhh, Rb^Qhh, Rb^Em, Ss, Ss, Ss^Em, Ss^Em, Ss, Ss, Ss, Ss, Sm, Sm, Sm, Sm, Sm, Ss, Ss, Ss, Ss^Qhu, Hhd, Gll^Fdw, Gll^Fmw, Ss, Ss^Qhu, Gll, Gll^Fmw, Gll, Gll^Fdw, Rb, Hhd, Rb, Gll^Fdw, Hhd, Hh, Hh^Fmw, Gs^Fmw, Hh^Fp, Hh^Fp
Rb, Gll^Qhhf, Sm^Em, Sm^Emf, Gll^Qhh, Gll^Qhhf, Gd^Qhhf, Sm, Sm, Ss, Ss, Ss^Em, Ss^Vhs, Ss^Emf, Ss^Em, Ss, Ss, Ss, Ss, Ss, Ss^Edb, Sm^Edb, Ss^Edb, Ss^Qhu, Ss^Qhu, Gll^Qhu, Gll^Qhuf, Gll^Fdw, Ss^Qhu, Ss^Qhu, Ss^Qhu, Rb^Fmw, Hhd^Fdw, Gll^Fmw, Rb^Fdw, Rb^Es, Hhd^Fmw, Rb^Fdw, Ss, Gll, Gll^Fmw, Gll^Fmw, Gs^Fmw, Gs^Fp, Hh^Fp
Gll, Rb, Sm, Rb^Qhh, Ss, Sm, Gll^Qhh, Sm, Sm^Edb, Sm, Ss, Ss, Ss, Ss, Sm^Qhu, Sm^Qhu, Sm^Qhu, Sm^Qhu, Ss, Ss^Edb, Ss, Ss^Edb, Ss^Em, Ss, Ss, Ss^Qhu, Gll^Qhuf, Ss^Qhu, Gll^Qhu, Ss^Qhu, Ss, Ss^Qhu, Ss^Qhu, Hhd, Ss^Qhu, Hhd^Em, Hhd, Ss, Ss^Em, Ss, Ss^Em, Ss^Emf, Gs^Em, Hh, Hh^Fp
Gd^Fmw, Gll^Fmw, Ss^Em, Sm, Ss, Sm, Ss, Sm^Em, Sm^Edb, Sm^Edb, Ss^Em, Ss, Sm^Qhu, Ss, Sm^Qhu, Sm^Qhu, Sm^Qhu, Sm^Qhu, Sm^Qhu, Sm^Qhu, Sm^Qhu, Sm^Qhu, Ss, Ss, Ss, Ss^Qhu, Ss^Qhu, Ss^Qhu, Ss^Qhu, Ss^Qhu, Ss, Ss^Qhu, Ss^Qhu, Rb^Es, Rb, Ss^Qhu, Ss^Qhu, Ss, Ss, Ss, Hhd, Ss, Gs, Gs^Fmw, Gs^Fp
Rb, Gd, Sm, Ss, Sm, Ss, Sm^Em, Sm, Chs, 5 Khs, Cme, Chs, Sm^Qhu, Ss, Sm^Qhu, Sm^Qhu, Sm^Qhu, Sm^Qhu, Sm^Qhu, Sm^Qhu, Ss, Ss, Ss, Ss, Ss^Wkf, Ss^Wkf, Ss, Ss, Wwrg, Ss, Ss, Ss, Ss, Ss^Qhu, Ss^Qhu, Ss^Qhu, Rb, Ss, Hhd^Fmw, Hhd^Fdw, Hhd^Em, Gll^Fmw, Hhd^Fmw, Gll^Fmw, Gs^Fp
Ss, Gd^Qhhf, Sm, Sm^Edb, Ss, Ss, Sm, Chs, Ss, Ss^Emf, Sm^Em, Sm, Sm, Sm^Qhu, Sm^Qhu, Sm^Qhu, Sm^Qhu, Sm^Qhu, Sm^Qhu, Sm, Ss^Em, Ss, Ss, Wwg^Wkf, Wwg^Wkf, Ss^Wkf, Ss^Wkf, Ss, Ss, Ss^Vhs, Ss, Ss^Em, Ss^Em, Ss^Qhu, Ss^Qhu, Gll^Fdw, Ss, Rb^Fdw, Rb^Es, Rb^Fmw, Gll^Emf, Hhd, Gll^Fmw, Gs^Fp, Gll^Fp
Ss, Gd^Qhhf, Sm, Sm^Edb, Sm^Edb, Ss, Sm, Sm, Ss, Ss^Em, Ss, Sm, Sm, Sm, Sm, Sm, Sm^Qhu, Sm^Qhu, Ss, Sm, Ss^Emf, Ss, Ss, Ss^Wkf, Wwg^Wkf, Wwg^Wkf, Ss, Ss, Wwrg, Ss, Wwf, Ss, Ss, Ss, Ss^Qhu, Gll, Gll^Fdw, Gll, Ss^Qhu, Gll^Fdw, Gll^Fmw, Gll^Fdw, Gll^Fmw, Gs^Fmw, Gs^Fp
Sm, Ss, Sm, Sm^Edb, Rb^Qhh, Sm, Gll^Qhh, Ss^Vhs, Ss, Ss^Em, Ss, Ss, Sm, Ss, Ss, Ss^Vhs, Ss, Ss^Em, Ss, Ss^Em, Sm^Em, Sm^Em, Chs, 3 Khs, Chs, Ss, Cme, Wwf, Wwrg, Wwrg, Ss, Wwf, Ss, Ss, Ss, Ss^Qhu, Ss^Qhu, Rb, Hhd, Gll^Fdw, Ss^Qhu, Gll^Fmw, Ss^Qhu, Gll^Fmw, Gs^Fp
Rb^Qhu, Rb^Fdw, Rb^Fmw, Rb, Rb, Gd^Qhhf, Gd^Qhhf, Ss, Ss, Ss, Ss, Sm, Ss, Ss^Em, Ss, Ss, Ss^Em, Ss^Em, Ss, Ss, Ss, Sm, Ss, Cme, Ss, Chs, 4 Kme, Wwf, Wwg^Wkf, Wwg^Vm, Ss^Em, Ss, Ss, Ss^Em, Ss, Ss, Ss, Rb^Es, Hhd^Fdw, Ss^Qhu, Ss^Qhu, Ss^Qhu, Ss^Qhu, Gll^Fmw, Gll^Fp
Rb, Rb^Fdw, Ss^Edb, Rb^Fdw, Rb, Ss, Gd^Qhhf, Gd^Qhhf, Gll^Qhh, Sm, Sm^Em, Ss, Ss^Vm, Ss, Tb, Ss, Ss, Ss^Emf, Tb, Tb^Emf, Tb^Emf, Ss, Ss^Em, Ss^Emf, Ss, Ss, Ss, Wwrg, Wwrg, Ss, Ss, Ss, Ss, Ss, Ss^Qhu, Ss, Ss, Rb, Rb^Fdw, Ss^Qhu, Gll^Qhu, Ss^Qhu, Gll^Fdw, Gll^Fmw, Gll^Fmw
Gll, Ss, Ss^Edb, Rb^Edb, Ss, Rb^Qhh, Rb^Qhh, Gll^Qhh, Sm^Em, Sm^Edb, Ss^Edb, Ss, Wwf, Cme, Tb^Tf, Tb^Tf, Ss^Em, Ss^Em, Ss^Tf, Tb, Ss, Ss^Em, Ss^Tf, Cme, Ss^Emf, Ss, Ss, Ss, Ss, Ss, Wwg^Ewl, Ss, Ss, Ss^Qhu, Rb^Es, Ss^Qhu, Ss^Qhu, Ss, Ss, Ss^Qhu, Gll^Qhuf, Ss^Qhu, Gll, Gll^Fdw, Gll
Rb^Qhh, Ss, Gll, Gll^Fdw, Gll^Fmw, Gll^Fdw, Gll^Fdw, Sm, Wwf, Sm^Edb, Chs, Wwrg, Ss^Emf, Tb, Tb^Emf, Tb^Tf, Ss^Tf, Tb, Tb^Emf, Tb, Tb^Tf, Tb^Emf, Tb^Tf, Ss^Tf, Ss, Ss, Wwrg, Ss^Vm, Ss, Ss, Ss, Wwrg, Ss, Ss^Qhu, Ss^Qhu, Rb, Ss^Qhu, Ss^Qhu, Ss^Qhu, Ss^Qhu, Ss^Qhu, Ss, Gll^Vhr, Gll, Gll
Rb, Rb^Qhh, Rb^Qhh, Gll^Fdw, Rb, Gll, Gll^Fdw, Gll, Chs, Chs, Wwf, Wwrg, Ss, Sm, Sm^Em, Ss^Emf, Ss^Tf, Tb^Tf, Tb^Tf, Tb^Tf, Tb, Tb^Emf, Ss^Em, Ss^Em, Tb^Tf, Ss, Ss, Wwg, Ss, Ss, Ss, Ss, Ss, Ss, Ss, Ss^Qhu, Gll^Qhuf, Gll^Qhuf, Ss^Em, Ss^Em, Gll^Fdw, Gll^Fdw, Gs, Gll^Fmw, Gll
Ss, Rb^Qhh, Rb, Rb, Gd^Qhhf, Ss^Qhu, Ss^Qhu, Ss^Qhu, Ss, 6 Kme, Cme, Wwf, Sm, Sm^Em, Tb, Tb^Emf, Ss^Tf, Ss^Tf, Ss^Emf, Tb^Emf, Tb, Tb^Tf, Tb^Emf, Tb, Ss, Ss, Ss, Ss, Ss, Wwf, Rb^Qhh, Ss, Ss^Qhu, Ss, Ss, Ss, Ss^Qhu, Gll^Qhu, Rb^Qhuf, Gd, Gd, Gd^Fdw, Gs^Em, Gll, Gll
Ss, Rb^Fdw, Rb^Fmw, Ss, Gd^Qhhf, Rb^Qhh, Ss^Qhu, Ss, Ss, Wwrg, Ss, Ss, Ss, Sm^Em, Tb^Emf, Tb, Ss, Tb, Tb^Tf, Tb^Emf, Tb, Ss, Ss^Em, Ss, Ss, Ss, Ss, Ss, Ss, Gll^Qhhf, Ss, Ss^Qhu, Ss, Ss, Ss, Ss^Qhu, Ss^Qhu, Rb^Qhu, Rb^Qhu, Gll^Qhuf, Gd^Fdw, Gs^Fmw, Gs^Fmw, Gs^Fmw, Gll
Ss, Rb, Rb^Fmw, Ss, Gd^Qhhf, Gd^Qhhf, Rb^Qhh, Ss^Qhu, Gd^Qhhf, Ss^Vm, Ss, Rb, Rb, Ss, Ss^Edb, Ss, Ss^Em, Ss^Em, Ss^Tf, Tb^Tf, Ss, Ss^Em, Ss^Em, Ss, Gll^Qhhf, Rb^Qhh, Gll^Qhhf, Rb^Qhh, Rb^Qhh, Ss^Qhu, Ss, Ss, Chs, 7 Kme, Cme, Ss, Ss, Ss^Qhu, Ss^Qhu, Rb^Qhuf, Gd^Fdw, Gs^Fmw, Gs^Fmw, Gs, Gs^Fp
Gll^Fdw, Rb^Fp, Gg^Fp, Ss, Gll^Fdw, Ss, Gd^Qhhf, Rb^Qhh, Gd^Qhhf, Ss, Rb^Qhh, Gll^Qhhf, Sm^Edb, Ss^Edb, Ss^Edb, Sm^Edb, Sm, Sm^Em, Cme, Tb, Ss^Emf, Ss, Ss, Gll^Qhh, Ss, Sm, Sm, Rb^Qhhf, Ss, Ss^Qhu, Ss, Ss, Ss^Vhs, Ss, Chs, Ss, Ss, Ss^Qhu, Ss^Qhu, Gll^Qhu, Gll, Gll^Fmw, Gs^Fmw, Gs^Fp, Gll^Fmw
Gll^Fp, Gll^Fp, Gll^Fp, Gll^Fmw, Gll^Fdw, Ss, Ss, Rb^Qhh, Gll^Emf, Gll^Fdw, Sm, Rb, Rb^Qhh, Sm, Sm^Edb, Sm, Sm^Em, Sm^Emf, Ss^Tf, Ss^Wkf, Ss^Wkf, Ss^Wkf, Ss, Ss, Ss, Ss, Sm, Sm, Rb^Fdw, Ss, Ss^Qhu, Ss^Qhu, Ss^Qhu, Ss, Ss, Ss^Qhu, Ss, Ss, Ss, Ss^Qhu, Gll, Gll^Em, Gs^Fp, Gs^Fp, Gll^Fmw
Gs, Gll^Fmw, Gll, Ss, Gll^Qhh, Gll^Qhh, Gll, Gd^Qhhf, Gll^Em, Gll^Em, Gll^Fdw, Sm, Rb^Qhh, Sm, Sm, Sm, Sm, Sm^Em, Ss, Ss, Ss^Wkf, Ss^Wkf, Ss^Wkf, Ss, Ss, Ss, Ss, Sm, Ss, Gd^Fdw, Gd, Ss^Qhu, Gd^Qhuf, Ss^Qhu, Ss^Qhu, Ss^Qhu, Ss, Ss, Ss, Ss, Gs^Fdw, Gs^Fmw, Gs^Fmw, Gs^Fp, Gs^Fmw
Gs^Fmw, Gll^Fmw, Gll^Fmw, Ss, Ss, Ss, Gll^Fdw, Gll, Gll^Em, Gll, Ss^Em, Gll^Qhhf, Ss, Sm^Em, Sm, Ss, Sm, Sm^Em, Sm^Emf, Ss, Ss^Wkf, Ss^Wkf, Ss^Wkf, Ss, Sm, Sm, Ss, Ss, Rb^Fdw, Rb^Es, Rb, Gll^Qhuf, Gd^Vhr, Gd^Qhu, Gll^Fdw, Ss, Ss, Ss, Ss, Gd, Gs, Gs, Gs, Gs^Fmw, Gs
Gg, Gd, Gd^Fmw, Gll^Fmw, Gll^Fdw, Gd, Gd^Fdw, Gll^Fdw, Gll, Ss, Ss^Em, Ss, Ss^Edb, Ss, Ss, Ss^Vm, Ss, Chs, Rb^Qhh, Gll^Qhhf, Ss^Vhs, Ss^Wkf, Ss^Wkf, Ss, Ss, Ss, Ss^Qhu, Rb, Rb, Gll^Fmw, Gll^Fp, Gd^Fmw, Gll^Fmw, Gd^Fmw, Gll, Gll^Fmw, Gll^Em, Gll^Fmw, Gd, Gd^Fmw, Gs^Fmw, Gd^Fmw, Gd, Gs^Fms, Gs^Fms
Gs^Fp, Gs, Gs, Gll^Fmw, Gs^Vhr, Gd, Gd^Fdw, Gll^Fmw, Rb^Fdw, Ss, Sm, Ss, Sm, Ss, Ss, Ss^Em, Ss^Em, 8 Kme, Chs, Gll^Qhh, Ss, Ss^Wkf, Ss, Ss^Qhu, Ss^Qhu, Ss^Qhu, Gll^Qhu, Ss^Qhu, Ss^Qhu, Gll^Fdw, Gll^Fmw, Gd^Fp, Gll^Fp, Gll^Fdw, Gll^Fmw, Gll, Gll^Fmw, Gll, Gs^Fmw, Gd^Fmw, Gs^Fp, Gs^Fmw, Gs^Fp, Gs^Fms, Gs^Fp
Gg, Gs^Fp, Gs^Fmw, Gs^Fmw, Gg^Fmw, Gd^Fmw, Gll, Gll, Gll, Gll^Fmw, Rb, Sm, Gll, Sm, Rb^Qhh, Gll^Qhh, Ss^Em, Ss^Em, Ss, Rb^Qhhf, Ss^Edb, Ss, Ss^Em, Ss^Qhu, Rb^Qhuf, Rb^Qhu, Gll^Qhuf, Ss^Qhu, Ss^Qhu, Gll, Gll^Fdw, Gll^Fmw, Gll^Fmw, Gll^Fmw, Gll^Fp, Gll^Fp, Gs^Fp, Gll, Gs^Fp, Gs^Fmw, Gs^Fms, Gs^Fp, Gs^Fp, Gs^Fp, Gs^Fms
Gg, Gs^Fp, Gg, Gs^Fmw, Gs^Fmw, Gd^Fmw, Gll^Fmw, Gll, Ss, Gll^Fdw, Rb, Sm, Gd^Qhhf, Gd^Qhhf, Gd^Qhhf, Gll^Qhh, Ss, Ss, Ss, Ss, Gll^Fdw, Gll^Edb, Gll^Fdw, Ss^Qhu, Gll^Qhu, Rb^Qhuf, Rb^Qhuf, Ss^Qhu, Rb, Gll^Fdw, Ss^Qhu, Gll^Fp, Gll^Fmw, Gll^Fp, Gs^Fmw, Gs^Fmw, Gll^Es, Gs^Fms, Gs^Fmw, Gg^Fms, 2 Gg^Fp, Gg^Fms, Gs^Fds, Gg^Fds, Gg^Fms
Gg^Fms, Gg^Fms, Gg^Fmw, Gg^Fmw, Gs^Fp, Gs, Gs^Fmw, Rb, Ss, Ss, Sm, Sm, Rb, Gd^Vhr, Gll^Qhh, Ss, Gll^Qhh, Ss, Ss, Ss, Gll^Em, Gll^Edb, Gll^Fdw, Ss^Qhu, Ss^Qhu, Gll^Qhuf, Ss^Qhu, Ss^Qhu, Ss^Qhu, Ss^Qhu, Gll^Fdw, Gll^Fmw, Gll^Em, Gll^Em, Gll^Fdw, Gll, Gs^Fp, Gs^Fmw, Gs^Fp, Gs^Fms, Gs^Fp, 1 Gg^Fp, Gs^Fp, Gs^Fds, Gs^Fds
Gg, Gg^Fp, Gg^Fmw, Gs^Fmw, Gs^Fp, Gg^Fp, Gs^Fmw, Rb, Rb, Gll^Fdw, Gll, Rb, Rb, Gll, Ss, Gd^Qhhf, Gd^Qhhf, Gll^Qhh, Rb^Qhh, Rb^Fdw, Rb^Em, Gll^Fdw, Gll^Fmw, Gll, Ss, Ss^Qhu, Ss^Qhu, Ss, Sm, Ss, Gd, Gd, Gll, Gll^Fmw, Gll^Fdw, Gll^Fmw, Gs^Fmw, Gs^Fp, Gs^Fms, Gs^Fp, Gg^Fp, Gg^Fms, Gs^Fms, Gs^Fp, Gs^Fds
Gs^Fms, Gs^Fms, Gs^Fmw, Gg^Fp, Gs^Fmw, Gs, Gs, Gs, Gll^Fdw, Ss, Gll^Fmw, Gd^Fdw, Gd^Fmw, Gll^Fmw, Gd^Qhhf, Gd^Qhhf, Gll^Fdw, Gll^Qhh, Ss, Ss^Em, Gll^Fmw, Gll^Fp, Gll^Fdw, Ss, Ss, Rb^Qhh, Sm, Ss, Sm^Vhs, Ss, Sm, Gd^Fdw, Rb^Edb, Rb, Gd^Vhr, Gd^Fdw, Gs^Em, Gs^Fmw, Gs^Fmw, Gs^Fmw, Gg^Efm, Gs^Fp, Gs^Fms, Gs^Fp, Gs^Fds
Gs^Fms, Gg^Fp, Gg^Fmw, Gs^Fms, Gs^Fp, Gg^Fmw, Gll^Fmw, Gll, Gll^Fmw, Gll, Gd^Fmw, Gd^Fdw, Ss, Ss, Rb, Gll^Qhh, Sm, Sm, Ss, Gll, Gll^Fdw, Gll^Fmw, Gll, Sm, Rb^Es, Rb^Qhh, Rb^Qhh, Sm^Edb, Sm^Edb, Rb^Em, Sm^Em, Sm, Rb^Edb, Rb^Edb, Gd^Fdw, Gd, Gs, Gs^Fmw, Gll^Em, Gs^Fp, Gs^Fmw, Gs^Fp, Gs^Fp, Gg^Fp, Gs^Fms
Gg, Gs^Fms, Gs^Fms, Gs^Fmw, Gs^Fp, Gll^Fmw, Gs, Gs, Gd, Gll^Fmw, Gll^Fdw, Gll^Fdw, Gll^Fmw, Gll^Fdw, Rb, Rb, Sm, Sm^Edb, Sm^Edb, Ss, Ss, Ss^Em, Sm, Sm, Sm, Rb^Qhh, Ss^Qhu, Sm^Edb, Ss, Cvr, Sm^Qhu, Sm, Sm^Qhu, Rb^Es, Rb^Es, Gd^Fdw, Gd, Gs^Fmw, Gll, Gs^Fmw, Gs^Fmw, Gs, Gg^Efm, Gg^Fms, Gg
Gs^Fms, Gs^Fms, Gs^Fp, Gs^Fms, Gs^Vc, Gs, Gg^Fmw, Gg^Fp, Gs^Fmw, Gll^Fmw, Gll^Fdw, Gd, Gll, Gll^Fmw, Gll, Gll^Fdw, Sm, Sm^Edb, Ss, Ss, Ss, Ss^Edb, Sm, Sm, Sm, Sm, Sm^Qhu, Ss^Qhu, 9 Kme, Chs, Ss^Qhu, Sm^Qhu, Sm^Qhu, Sm^Qhu, Sm, Sm, Rb^Fdw, Gd, Gll^Fdw, Gs, Gs, Gs^Fmw, Gg^Fp, Gs^Fms, Gg^Fms
Gg, Gs^Fp, Gs^Fms, Gs^Fms, Gs^Fms, Gs, Gg^Fms, Gg^Fp, Gs^Fms, Gg^Fp, Gs^Fp, Gd^Fmw, Gll^Fmw, Gll^Fdw, Rb^Qhh, Sm, Sm, Ss, Sm, Gll^Qhhf, Sm, Rb^Qhhf, Rb^Qhh, Gll^Qhhf, Gll^Qhhf, Rb^Qhh, Sm^Qhu, Sm^Qhu, Ss^Edb, Chs, Ss^Qhu, Ss^Qhu, Sm^Qhu, Sm^Qhu, Sm^Qhu, Sm, Rb^Fdw, Gll^Fmw, Gll^Em, Gll^Fmw, Gll^Fmw, Gs^Fp, Gs^Fp, Gg^Fms, Gg^Fms
Gg^Fp, Gs^Fp, Gs^Fms, Gs^Fms, Gs^Fms, Gg^Fp, Gg^Fms, Gg^Fp, Gg^Fp, Gs^Fms, Gs^Fp, Gs^Fp, Gll^Fmw, Gll, Rb^Qhh, Rb^Qhh, Gll, Gll^Fdw, Sm, Sm, Rb^Qhh, Sm^Em, Sm^Emf, Gll^Qhh, Gll^Qhh, Rb^Qhh, Rb^Qhh, Ss^Qhu, Sm, Ss^Qhu, Ss^Em, Ss^Qhu, Ss^Qhu, Sm^Qhu, Sm^Qhu, Ss^Qhu, Ss^Qhu, Ss^Qhu, Gll^Fdw, Gll^Fdw, Gll^Em, Gll^Fmw, Gll^Fmw, Gs^Fp, Gll^Fp
Gg, Gg^Fp, Gg, Gg^Fp, Gg, Gg^Fmw, Gg^Fms, Gg^Fmw, Gg^Fp, Gg^Fp, Gg, Gs, Gs, Gll^Fdw, Gll, Gll^Fdw, Gll, Gll^Fdw, Sm, Gll, Gll, Rb^Qhh, Gll, Rb^Qhh, Gll, Rb^Qhh, Rb, Sm, Ss^Qhu, Ss^Qhu, Ss^Qhu, Sm^Qhu, Sm^Qhu, Sm^Qhu, Sm^Qhu, Ss^Qhu, Sm, Ss^Edb, Ss, Gll^Fdw, Gll, Gll, Gll, Gll^Fmw, Gs
